111111111111111111111111111111
100000000000000000000000000001
100P00000000000000000000000001
100000000000000000000000000001
100000000000000000000000000001
100000000000000000000000000001
100000000000000000000000000001
100000000000000000000000000001
100000000000000000000000000001
100000000000000000000000000001
100000000000000000000000000001
100000000000000000000000000001
111111111111100000000000000001
100000000000100000000000000001
1000C0000000100000000000000001
100000000000100000000000000001
10011111111110C000000000E00001
100000000000000000000000000001
111111111111111111111111111111